/usr/bin/python3 "/Users/sanghyunkim/Documents/Algorithm-Template (Git)/Python/DFS/DFS-Maze.py"
===step1====
x 0 1 1 1 1 1 1 
1 0 0 0 1 0 0 1 
1 1 0 1 0 0 1 1 
1 1 0 1 0 0 0 1 
1 0 0 0 0 1 0 e 
1 1 0 1 1 1 1 1 
===step2====
x x 1 1 1 1 1 1 
1 0 0 0 1 0 0 1 
1 1 0 1 0 0 1 1 
1 1 0 1 0 0 0 1 
1 0 0 0 0 1 0 e 
1 1 0 1 1 1 1 1 
===step3====
x x 1 1 1 1 1 1 
1 x 0 0 1 0 0 1 
1 1 0 1 0 0 1 1 
1 1 0 1 0 0 0 1 
1 0 0 0 0 1 0 e 
1 1 0 1 1 1 1 1 
===step4====
x x 1 1 1 1 1 1 
1 x x 0 1 0 0 1 
1 1 0 1 0 0 1 1 
1 1 0 1 0 0 0 1 
1 0 0 0 0 1 0 e 
1 1 0 1 1 1 1 1 
===step5====
x x 1 1 1 1 1 1 
1 x x x 1 0 0 1 
1 1 0 1 0 0 1 1 
1 1 0 1 0 0 0 1 
1 0 0 0 0 1 0 e 
1 1 0 1 1 1 1 1 
===step6====
x x 1 1 1 1 1 1 
1 x x x 1 0 0 1 
1 1 x 1 0 0 1 1 
1 1 0 1 0 0 0 1 
1 0 0 0 0 1 0 e 
1 1 0 1 1 1 1 1 
===step7====
x x 1 1 1 1 1 1 
1 x x x 1 0 0 1 
1 1 x 1 0 0 1 1 
1 1 x 1 0 0 0 1 
1 0 0 0 0 1 0 e 
1 1 0 1 1 1 1 1 
===step8====
x x 1 1 1 1 1 1 
1 x x x 1 0 0 1 
1 1 x 1 0 0 1 1 
1 1 x 1 0 0 0 1 
1 0 x 0 0 1 0 e 
1 1 0 1 1 1 1 1 
===step9====
x x 1 1 1 1 1 1 
1 x x x 1 0 0 1 
1 1 x 1 0 0 1 1 
1 1 x 1 0 0 0 1 
1 x x 0 0 1 0 e 
1 1 0 1 1 1 1 1 
===step10====
x x 1 1 1 1 1 1 
1 x x x 1 0 0 1 
1 1 x 1 0 0 1 1 
1 1 x 1 0 0 0 1 
1 x x x 0 1 0 e 
1 1 0 1 1 1 1 1 
===step11====
x x 1 1 1 1 1 1 
1 x x x 1 0 0 1 
1 1 x 1 0 0 1 1 
1 1 x 1 0 0 0 1 
1 x x x x 1 0 e 
1 1 0 1 1 1 1 1 
===step12====
x x 1 1 1 1 1 1 
1 x x x 1 0 0 1 
1 1 x 1 0 0 1 1 
1 1 x 1 x 0 0 1 
1 x x x x 1 0 e 
1 1 0 1 1 1 1 1 
===step13====
x x 1 1 1 1 1 1 
1 x x x 1 0 0 1 
1 1 x 1 0 0 1 1 
1 1 x 1 x x 0 1 
1 x x x x 1 0 e 
1 1 0 1 1 1 1 1 
===step14====
x x 1 1 1 1 1 1 
1 x x x 1 0 0 1 
1 1 x 1 0 0 1 1 
1 1 x 1 x x x 1 
1 x x x x 1 0 e 
1 1 0 1 1 1 1 1 
===step15====
x x 1 1 1 1 1 1 
1 x x x 1 0 0 1 
1 1 x 1 0 0 1 1 
1 1 x 1 x x x 1 
1 x x x x 1 x e 
1 1 0 1 1 1 1 1 

Find the exit!
Search 15 times

